1111111111111
1111122211111
1111222221111
1112222222111
1111222221111
1111122211111
1111111111111
