0 0 0 0 0 1 0 0 0 0 0 0 0 1 0 0
0 0 0 1 0 0 1 1 0 0 0 1 0 0 1 1
0 1 1 1 0 0 0 1 0 1 1 1 0 0 0 1
0 0 0 0 1 0 0 0 0 0 0 0 1 0 0 0
0 1 0 0 0 0 0 0 0 1 0 0 0 0 0 0
0 1 0 1 0 0 1 0 0 1 0 1 0 0 1 0
0 0 0 0 0 1 0 0 0 0 0 0 0 1 0 0
0 0 0 1 1 0 0 0 0 0 0 1 1 0 0 0
0 0 0 0 0 1 0 0 0 0 0 0 0 1 0 0
0 0 0 1 0 0 1 1 0 0 0 1 0 0 1 1
0 1 1 1 0 0 0 1 0 1 1 1 0 0 0 1
0 0 0 0 1 0 0 0 0 0 0 0 1 0 0 0
0 1 0 0 0 0 0 0 0 1 0 0 0 0 0 0
0 1 0 1 0 0 1 0 0 1 0 1 0 0 1 0
0 0 0 0 0 1 0 0 0 0 0 0 0 1 0 0
0 0 0 1 1 0 0 0 0 0 0 1 1 0 0 0
*
. . . t . . . . . . . t . . . .
. p . t . t . . e . . t . t . .
. t . . . . . t . t . . . . . t
. . . t . t . . . . . t . t . .
. . . . . . . . . . . t . t . .
. t t . e . t . . t t . . t . .
. . . . . . . . . . . t . t . . 
. t t . . t . . . t t . . t . .
. . . t . . . . e . . t . . . .
. . . t . t . . . . . t . t . .
. t . . . . . t . t . . . . . t
. . . t . t . . . e . t . t . .
. . . . . . . . . . . t . t . .
. t t . . . t . . t t . . t . .
. . . . . . . . . . . t . t . . 
. t t . . t . . . t t . . t . .



