0 0 0 0 0 1 0 0
0 0 0 1 0 0 1 1
0 1 1 1 0 0 0 1
0 0 0 0 1 0 0 0
0 1 0 0 0 0 0 0
0 1 0 1 0 0 1 0
0 0 0 0 0 1 0 0
0 0 0 1 1 0 0 0
*
. . t . . . . t
. p . . . t . .
. . . . . . . .
. t . t . t . .
. . . . . . . .
. . . . . . . .
. t . t . . t .
. . . . . . . .


